# name=Maze Benchmark
# width=128
# height=128
# tile_size=32
# time_limit=300
# minion_cap=100
TTTTTTTTTTTTTTTTTTTTTTTTTTTTTTTTTTTTTTTTTTTTTTTTTTTTTTTTTTTTTTTTTTTTTTTTTTTTTTTTTTTTTTTTTTTTTTTTTTTTTTTTTTTTTTTTTTTTTTTTTTTTTTTT
TDDDDDDDDDDDDDDDDDDDDDDDDDDDDDDDDDDDDDDDDDDDDDDDDDDDDDDDDDDDDDDDDDDDDDDDDDDDDDDDDDDDDDDDDDDDDDDDDDDDDDDDDDDDDDDDDDDDDDDDDDDDDDDT
TDDDDDDDDDDDDDDDDDDDDDDDDDDDDDDDDDDDDDDDDDDDDDDDDDDDDDDDDDDDDDDDDDDDDDDDDDDDDDDDDDDDDDDDDDDDDDDDDDDDDDDDDDDDDDDDDDDDDDDDDDDDDDDT
TDDDEDDDDDDDDDDDDDDDEDDDDDDDDDDDDDDDEDDDDDDDDDDDDDDDEDDDDDDDDDDDDDDDEDDDDDDDDDDDDDDDEDDDDDDDDDDDDDDDEDDDDDDDDDDDDDDDEDDDDDDDDDDT
TDDEGCGMGGGGMTMGGGGTGGGGGMMGGGGMGGGGGTGMGTGGGMGMGGGGGGGMMGGTGGGGGTGGMGGGGTMGMMMGMMMTGGMMGGGMGTGGGGGGMTGMGGGMGTMGGTGGGTMGGGGTEDDT
TDDDGTTTTTGTGTGTGTTTMTTTTTTTTTTTGTTTGTTTGTGTTTTTTTTTMTTTTTGTGTTTMTTTGTTTMTGTMTTTTTTTGTTTTTGTGTTTTTMTGTGTTTGTGTGTMTTTGTGTTTGTDDDT
TDDDGGGMMTGTGTGTGGGGGTMMMTGGGGGTGGGTGGGTMTGTMGGGGGGTMGGGGTGTGTMGGGGGGTGMMTGTGMGGGGGGGTMMGTMTMGGGMTMTGGGTGGGTGTGTGMGTGGGGGTGTDDDT
TDDDTTTTGTGTTTMTTTTTTTGTTTMTTTGTTTGTTTMTGTGTTTGTGTTTTTTTGTGTGTTTTTTTTTTTTTGTTTTTTTTTTTGTGTGTTTTTGTTTGTTTGTTTGTGTTTGTTTTTGTMTDDDT
TDDDGGMGMTGGGTMTGGGGMMGGGTGTGTMGGTGTGGMGGTMGGTGTGTGGMGGMGTGTMGGGMGGGGTGMMTMGGTMMGGGGGTGTGMGTGGGTMMGTMGGTGGGTGMGTGTGGMTMMGTGTDDDT
TDDDGTTTTTTTGTGTTTTTTTTTMTGTGTTTGTGTTTTTTTTTMTTTGTMTTTTTTTGTTTGTTTTTGTGTGTTTGTGTTTTTGTMTTTTTGTGTTTGTTTTTTTGTTTTTGTTTGTTTTTGTDDDT
TDDDMGGTMMMGMTMGMGGGGGGMMTGTGGGGGTMTGGMGGGGTGTGGGTMTMGGGMTGMGTGTMGGGGTGTGTGGGTGTGGMTMGMTGTGMGTGTGGGTGGGGGGMTGMGMGTGTGGGGGGGTDDDT
TDDDTTMTMTTTTTTTTTTTTTTTGTMTTTTTGTGTMTTTTTGTGTGTTTMTGTTTTTTTGTTTMTTTTTGTGTGTTTGTGTTTTTTTGTGTTTGTGTTTGTTTTTTTMTTTMTGTTTTTTTMTDDDT
TDDDMMGTGGGGMGGGMGGTGGMTGTGGMMGTGGGTGGMGGTGTMTGTGMMTGGGGGGMTMMGTGGGGMTMTGMGTGTMTMGMMGGGMMMMTGTGMGTGGGTMGGTMGMTGGGGGGMTGGGGMTDDDT
TDDDGTTTGTTTTTTTTTGTMTGTGTTTTTGTTTTTGTTTTTGTMTGTMTTTTTTTGTGTTTGTTTGTGTGTTTTTMTMTTTTTTTTTTTGTMTTTTTMTTTGTMTTTMTMTTTTTTTGTTTTTDDDT
TDDDGTGMGMMTGGGMGTGGMTGTGGGTGTGGMGGMMTGGGTGTGTGTGGGTGGMTGTGMMTGGMTMTMTMGMTGGGTMGGMMGGMMGMTGGMTGGMGGGGTGTGGGGGTGGGTGGGGMTMGGTDDDT
TDDDGTTTTTGTMTTTGTTTTTMTTTGTGTTTTTTTTTGTGTGTMTGTTTGTMTGTTTGTTTTTMTGTMTTTGTMTGTTTTTTTTTTTGTTTGTTTTTTTGTGTTTMTTTTTGTGTTTTTTTMTDDDT
TDDDGGGTGGGTGTMTGGGMMTGMGTGTGMGGGGGTGMGTGMGTGGGTMTGTGTGGGTGTGGMMGTGTGMGTGMGTMGGMGTGGMGGGGTGGGGMGGMGGGTGGGTGTGGMTGTGTGGGGGGGTDDDT
TDDDTTGTTTGTGTGTTTTTGTGTTTGTTTTTTTMTMTTTTTMTTTMTMTMTGTTTMTMTGTTTTTTTTTGTTTTTTTGTTTGTTTTTMTTTTTTTTTTTTTGTGTMTGTGTTTGTGTTTTTGTDDDT
TDDDGTGGGTGTGTGTGGGMGTMGGMGTGGGTGMGTMTGGGGGTGTGGGTGGMTGTGTGTGGGTGMMGGTGGGGGTGTGTMGMTMMMTMTGMGTGGGTMGGGGTMTGTMTGGGTGTGMGTGTMTDDDT
TDDDGTTTMTTTGTGTMTTTTTTTTTGTGTMTGTTTGTGTTTTTMTTTGTTTTTGTGTGTTTGTTTGTGTTTGTGTGTGTGTTTMTGTGTMTGTTTMTMTTTTTGTMTMTTTMTMTTTGTGTGTDDDT
TDDEGGGTGMGTGTGGMGMGGGGMGTMGGTGGGTMGMTGMGGGMGTMGGTGGGGGTGTGGGTGTMGGTMGGGGTGGMTGTGTMGGTGGGTGTGGGTGGGTGGGGMTGTMTGGGTMMGTGTGTGTEDDT
TDDDGTTTTTGTMTTTTTTTTTTTGTTTTTTTMTGTTTTTTTTTTTGTTTGTTTTTGTGTTTMTGTTTTTTTTTGTTTGTMTTTTTTTTTGTTTMTMTTTMTTTTTTTMTGTGTTTGTGTGTGTDDDT
TDDDGGGGGGMTGGGTMTMMGGGTGGGGGTGGGTGGGTGGGGGGGGGTMGGTMGGGGTGMGMGTGGMTGGMTGTGTGGGTGGGMGGGTGGMTMTGTGTGTMGGGGGGGGTGTGGGTGTGTGMGTDDDT
TDDDMTTTTTTTGTGTMTGTTTGTTTTTGTTTTTGTGTGTTTTTTTTTTTGTGTTTTTMTTTTTTTGTMTGTGTMTGTTTTTTTTTGTGTTTGTGTGTMTTTTTTTTTTTGTMTTTGTGTTTMTDDDT
TDDDGGGGGTGGGTGTGGGTMGGGGGGTGGGGGTGTGGMTMMMMGGGGGMGTGTGTGGGTGGGGGTGMGTGTGGGTMGGGGGGMGTGTMTMGGTGTGGMGMTGGMTGTGGGTGTMGGTGMMTGTDDDT
TDDDTTTTGTGTTTGTGTTTGTTTTTTTTTTTGTGTTTTTTTGTTTTTTTGTGTGTMTTTGTTTMTTTTTGTGTTTTTTTGTTTTTGTMTGTTTGTTTTTGTGTMTGTGTTTTTGTTTGTGTGTDDDT
TDDDGTGGGTMTGGGTGGGTGGGMGTMMGGMTMTMGGGMGGTMGGTGGMTGTGTGMGMGTGTGGGGGGMTGTGTMGGGMTGTGGGTMTGGGTGMGTGGGTGGMTGTMTGGGGMTGMMTMTGTMTDDDT
TDDDMTGTTTTTMTTTTTMTTTTTGTMTTTGTGTTTTTTTGTGTGTMTTTGTMTTTTTMTMTTTTTTTGTGTTTGTTTGTMTGTGTMTMTTTGTTTTTGTTTTTGTMTTTTTGTTTGTGTGTGTDDDT
TDDDMTGTGGMTMMGTMTMGMTGTGTGTGGMTGGGGGMGTGTGTGTGGMGGTMMMTGGMTGGGGGTGTGTGGMGGTGTMGGTGTGGGTGTGMGTGGGTGGGGMTGTMGMGGTGTGGGTGTMTMTDDDT
TDDDMTMTGTGTGTGTGTTTGTGTGTGTGTMTTTTTTTMTGTTTGTMTTTTTTTGTGTTTTTTTMTMTGTGTTTTTGTTTTTGTTTTTGTMTTTGTGTTTGTGTGTTTTTMTGTMTTTGTMTGTDDDT
TDDDGTGGGTGTGTGTGTGMGTGTGGGTGTMTGGGGGTMTGGGGGTGGGTGGGTGTGGGTGGGGGTMTGTGMGTMGMGMTGTGMGMGGMTMTMGGTGGGGMTGTGGGGGGGTGTMGGTGTGTMTDDDT
TDDDGTTTTTGTGTGTMTGTTTGTTTTTGTTTGTGTMTMTTTTTTTTTMTGTTTGTTTGTGTTTTTGTGTTTMTTTGTGTMTTTTTTTTTGTGTTTTTTTTTTTTTTTGTTTMTTTMTGTGTTTDDDT
TDDDGTGGMMGTMTGTGGGTMGGGGGGTMMGMMTGTGTGTGGGTGGMTGMGTMGGTGMMGGTGGGTGGGTGGMMGMGTGMGGGTGGGTMGGTMMGGGGGTGGMGGMGTGTGMGTMGMTGTGGGTDDDT
TDDDGTGTTTTTGTMTGTTTGTTTGTGTTTTTTTFTGTGTTTGTMTGTMTTTGTTTGTTTTTTTMTMTTTTTTTTTTTTTTTGTGTGTGTTTGTTTTTGTGTMTTTTTGTGTTTGTTTTTTTMTDDDT
TDDDMTGGGTMGMTGTGMGTGGGTMTGTGGGGGGMTGTMGGTGGMTGGGTMMMTGGGGGTGMGTGMGGGGMMGMGMMTGGGMGTMTGTMTGMGFMGGTGGGTGMGTGGGTGGGGGTMMGGGGGTDDDT
TDDDGTTTGTTTTTMTTTMTGTTTMTTTGTTTTTTTTTTTGTTTTTTTTTGTTTTTTTGTGTMTGTTTTTTTTTTTGTGTTTTTGTTTMTTTTTTTTTTTTTTTGTMTTTTTTTTTGTTTTTGTDDDT
TDDEGGGTGGGMGMGTMGGTGTGGMTMGGTGMGGMGGGGTGGMTGGGGGTGGGTGGMTGTGTGTMGGTGGMGGTGGMTGTGTMMGGGTMTMMMMGGGGGGGGGTGGMTGMGMGMGMGTGGGGGTEDDT
TDDDGTGTTTTTTTTTGTTTGTGTTTGTTTMTTTTTTTGTTTMTGTTTGTTTGTGTMTTTMTGTTTTTGTTTGTGTTTGTMTGTTTGTGTGTTTTTTTTTTTMTTTMTTTGTTTTTTTGTTTTTDDDT
TDDDGTGGGGGGGTGGGTGGGTGTMGMTGGGTGGGMGTGGGMMTMMGTGTGGGTMTGGGMGTGTGMGMGTMTMTGGMTGTGGGTGGGTGTGTGGMGGGGGGTGMGTGGGGGTMGGGGTMTGGGTDDDT
TDDDGTTTTTMTTTGTTTTTTTGTGTTTGTTTGTGTMTTTTTTTGTGTGTGTTTGTTTTTTTGTGTTTTTGTGTTTGTGTTTTTMTGTGTGTTTTTTTGTMTTTMTTTTTTTTTTTGTGTTTGTDDDT
TDDDGGGTGGGTMGGTMGMGMGGTGMMMGTMGGTGTMTGGGMMTGTMTGTGGGGGGGTGMGTGTGGGTGMGTMTGTGTGGGGGTMTGTGTGGGMMMGTGTGGGTGGMGGTGGMMGGGTGTGGMTDDDT
TDDDTTGTTTTTGTTTGTTTTTGTTTTTTTTTTTGTTTMTGTTTMTMTMTTTTTTTTTGTGTGTTTGTMTTTGTGTGTTTTTGTGTGTMTTTTTTTGTGTTTGTTTTTGTGTGTTTMTGTGTGTDDDT
TDDDMMGTGGGTMGMGMTGGGTGTMGGGGGMGGTGGMMGTGTGGGTGTGTMGGGMGMGGTGTGGGGMTMGGTGTGTGGGTGGGGGTGTGGGMGTGGMTGTGTGGGTMGGTMTGTGMGTGGGTGTDDDT
TDDDGTTTGTMTTTTTTTGTGTGTTTGTTTTTGTGTTTTTMTGTTTGTGTMTTTTTTTTTGTTTTTMTTTGTMTGTTTMTTTMTTTTTTTGTGTGTTTGTGTTTMTGTTTTTGTMTTTTTTTMTDDDT
TDDDGGGTGTMMGTMGGGGTGTGGGTGGMGGTGTGGGMMTGMMTGTGTGTGTMGGGMTGTGMMGGTGGMTGTGTGGMTGGGTMTGMGGGTGTGTGTMMGTGGGTGTGTGMMGMTMGGTGGGTGTDDDT
TDDDGTMTGTTTGTMTTTMTTTTTGTTTGTGTGTTTTTGTTTTTGTMTGTGTGTTTMTGTTTTTGTTTGTGTGTGTTTTTGTTTGTTTMTGTTTMTGTTTGTTTGTGTTTMTTTGTTTMTGTMTDDDT
TDDDGTMGGTGTGTGGGTGGMGMTMMGTGTMTGTMGGGGTMGGGGTGTGTGGGTGGMTGTGMGGGTGGGGGTGTGMGTGMMTGGGTGGMMMTGGGTGGGTGTGGGTGTGGMTGGGTGGMTMGGTDDDT
TDDDGTTTTTMTGTTTGTTTGTGTTTGTTTMTMTGTTTTTMTTTTTGTGTTTTTGTTTGTGTTTTTTTTTTTGTTTGTMTTTGTTTTTTTTTGTTTTTGTMTMTTTGTGTTTTTTTGTTTTTTTDDDT
TDDDGGMGGGMTMGGGGTMGGTGTGTGTGGMTGTGGGMGGGTMGGGGTGGGTGGGTGGGTGGGTGGGTGGGGGTGMGTGTGTMMMMGGGGGTMTGGMMGGMTGTGGGTMGGGGGMGMTGGGMGTDDDT
TDDDTTGTTTTTTTTTTTGTTTGTMTGTGTTTGTTTMTTTTTGTTTTTTTGTGTTTGTTTTTMTGTGTMTTTTTMTTTGTGTGTTTTTTTGTGTTTTTTTMTGTGTTTTTTTTTGTTTTTTTGTDDDT
TDDDMMGTMGGGGGMGGMGTMTGGGTGTGGGTGTGTGTGGGMGTGGMGGTGGGTGGGGMGGTMGGTMGGTGGGGGMGMGTMGGTGGGGMGMTGGGGMTMTMTGTGMMGGTGGGTGGGGGGGTGTDDDT
TDDDGTTTMTTTMTTTTTTTMTTTGTMTTTMTGTGTGTGTTTTTTTGTTTTTTTTTTTGTTTTTTTTTTTMTTTTTTTTTTTMTGTTTTTTTTTTTGTGTGTGTTTTTMTGTGTTTTTTTGTGTDDDT
TDDEGTGGGTGTGTGGGTMGGTGMGTMGGGMTMTGMGTMGGTGGGGGTGGMGGGGGMTGGMGMMGGGTGGGTGGMGGGGGGTMTMMMGGGMGGGMTGTGGMTGGGGGTGGMTGTGGGGMTMMGTEDDT
TDDDTTMTTTGTGTGTGTGTGTGTTTTTTTTTGTGTTTTTGTMTMTGTGTMTTTTTMTTTTTTTGTGTGTTTGTTTTTTTMTGTTTTTTTTTTTMTGTTTGTTTTTGTTTTTMTTTTTGTTTGTDDDT
TDDDGGMTGMGGMTGTGTGTMTGTGGGGGGGTGTGTMGGGGTGTMTGTGTGGMTGTGTGMGTGMMTGTGGMGGTGTMMGTGTGTGGMGGGMTMGGTGGMTGTMGGGMGMMMTGMGGMTGMMTGTDDDT
TDDDGTTTTTGTTTGTMTTTGTMTMTTTMTGTGTTTMTTTTTTTMTTTGTTTGTGTGTGTGTGTTTMTTTTTTTMTMTGTMTGTGTTTTTTTGTTTTTMTTTGTTTTTTTGTTTTTMTGTGTGTDDDT
TDDDGTGGGTGTMGGTGMGTMTGTMTMGMTGTGGGTGGGMGGMTMGGGGTMMGTGGGGGTMGGTGTGGGMGTMGGGGTGGGTMTGGGGGGGTMTGMMTGGMMGTGGGMGTMGMGMTGTMTGMGTDDDT
TDDDGTMTGTTTGTTTTTGTGTMTMTGTMTTTTTGTTTTTTTGTTTTTTTGTTTTTTTTTTTTTMTTTTTGTGTTTTTTTTTGTTTTTTTMTGTGTMTTTTTTTGTTTTTTTTTGTMTTTMTTTDDDT
TDDDGMMTGTMGGTGMGTGTGTMTGTGTGTGMMTMGGGGGGTGTGGGTGMGTGGGTGGGTMGGMGGGGGTGTGGMTGMGGMTGMMGMGGGGTGGGTGGGMGTGMMTGMGMGGGTMTGMMTGGGTDDDT
TDDDTTTTGTMTTTMTTTMTGTGTGTMTTTGTGTTTTTTTGTGTGTGTGTTTGTGTGTGTGTTTTTTTMTGTTTGTTTGTGTTTTTTTTTMTTTTTGTTTGTGTMTGTTTMTTTMTTTMTTTGTDDDT
TDDDGGMGGTGMGGMTGMGTMMGTGTMTGGGTGGGGMGMTGTGGGTGTGTGGGTMGGTGTGGGMMTGGMTGTGTGGGGMTGMGTGGGGMTGGGTGGGTGGGTGTGTGTMTMGGGMTGTMTGMGTDDDT
TDDDMTTTTTTTTTMTGTTTGTTTTTGTGTTTGTTTTTMTGTGTTTGTMTGTTTTTTTMTTTTTGTMTGTGTMTTTTTTTTTGTMTTTTTTTGTGTTTGTTTMTMTGTGTTTTTTTGTGTTTMTDDDT
TDDDGTGMGTMGMTMTGTGGGGGGGGMTGTGMGTGGGTGTGTGTGGMTGTGGGGMMMTGTGGGTGTGTGTMGMMMTGGGGGTGTGTMMGGMGGTGTGTMGGTGTGGMTGGGMGGGGGTGGGTGTDDDT
TDDDGTGTGTGTMTMTGTTTTTTTTTTTGTGTTTMTGTGTMTTTMTTTGTTTTTMTTTGTGTTTMTGTTTTTMTTTGTMTTTGTMTGTTTTTTTMTGTTTGTGTTTTTTTTTTTGTTTTTGTTTDDDT
TDDDGTGTMTGTGMGTGGGGGGGGGGMTGTMTMGMTGGMTMGGTGGGTGTGGGTGTGMMTMTMGMTGMGGGMGTGGMTMMMGGTGMGGGGGGGTGTGTGGGTGTMGGGMTMGGTGMMGGTGGGTDDDT
TDDDGTMTMTGTTTTTTTTTTTTTTTGTMTMTGTTTTTTTTTGTGTGTGTMTGTGTGTTTMTGTTTTTTTTTTTGTTTTTTTTTTTTTTTTTTTGTMTGTTTGTGTTTGTGTGTTTTTMTTTGTDDDT
TDDDGTGTGTGTGGGGMMGTGTGGGTGGGTGTGGMGGGGTMGGTGTGTGTGTMGMTGTGGMGGMMGGGGTGGMGGTGGMGGGGGGGMGMGGGGTGTGGMGGTGTGMGTGGGTGMGGMGGTGMGTDDDT
TDDDGTGTMTGTGTTTTTGTGTGTMTTTTTMTMTTTTTTTGTTTTTGTGTGTTTTTGTGTTTTTTTTTGTGTTTTTMTGTTTTTTTTTTTTTGTGTTTTTTTGTTTMTTTTTTTTTTTGTMTMTDDDT
TDDEMGGTMGGTMGGTMGGMGTGTGGGGGGMTGTGMGGGGGTMGGGGTGGGTGGMGMTGTGGMGGGGTGTGTGGMTGTGTGGGGGGMGGTGTMTGTGMGGMMGGGTGTGGMTGGGGGGGTGTMTEDDT
TDDDMTTTTTTTMTMTTTTTMTGTGTTTTTTTGTGTTTTTTTGTTTTTGTTTGTTTGTTTGTTTTTGTTTGTGTGTMTGTGTTTGTTTGTGTGTGTMTTTTTTTGTGTGTGTGTTTTTTTGTTTDDDT
TDDDGTGMGTMGMTGGGTGTGTGTGTGGGGGTGTGTGTGGMGGTMGMTGMMTMTGTMTMGGTMGMTGGGTGGGTMTGTGTGMGTGTGGGTMTMTGGGGGTGGGTGGMTGTMTMGGMMGGTGGGTDDDT
TDDDGTGTGTTTTTTTGTMTGTMTTTGTTTGTTTMTGTGTTTGTGTGTTTMTMTGTMTGTTTTTGTTTGTTTTTMTGTGTTTTTGTTTGTMTGTTTTTTTGTGTTTTTGTTTTTTTTTGTTTGTDDDT
TDDDMTGTGGGGGGGTGTMGGTGTGGGTGTGGMMGTMMGGGTMTGTGGGTGTGTGMGTGMMGMTGMMTGGMGMTGTGTGGMGGTGGMTGMMTGGGMGGMMGTGGMTMGGGGMMGGGGMGTGGGTDDDT
TDDDGTGTTTTTTTMTGTTTGTGTMTTTGTTTTTTTGTTTTTGTGTTTTTGTMTGTTTTTTTGTTTGTTTTTGTGTGTTTTTGTGTGTGTTTTTTTTTTTTTTTGTGTTTTTTTGTTTTTGTTTDDDT
TDDDGTGTMGMMMGMTGGGTGTGGGTGMMTGGGTGGGTMGGGGTGTGGMGGTMTGGMTGGGTGGGTGGGTMTGGMTGTGMGGGTGTGTGTGMMGMMGGGGGGGMGTGTGMGGGTGGGGGTGGGTDDDT
TDDDMTGTTTTTMTTTMTMTGTTTTTGTTTGTGTGTTTGTTTTTGTGTTTTTGTTTGTMTGTTTGTGTGTGTTTTTTTGTTTTTGTMTMTMTTTTTTTTTTTTTTTTTMTTTGTTTTTTTTTGTDDDT
TDDDGTMGMMGTMTGTGTMTMTMMMGMGGGGTGMGGGTGGGGMTGTMTGGGTGTGTGGGTGTGMMTGTGGGGMGGMGMMTGGGGMTMTGTGGGTGTGGMGGMGGGTGGGTGTGMGTGGGGGTMTDDDT
TDDDMTTTTTGTMTGTGTMTMTTTMTTTTTTTTTTTTTTTTTGTGTGTGTGTMTGTTTTTGTMTTTGTTTTTTTTTTTTTGTTTTTMTTTTTGTMTGTTTGTTTGTMTTTGTTTGTGTTTGTMTDDDT
TDDDGGMTGGGTGTMTGTGTGGGTMTMGMGMTGMGMMGMTGGGTGGGTGTGTMTGMGGGTGTGGGTGTGGGGGGGGGTMMGTGGGTGTGMGGGTGTMTMGGTMGGTGTGGGMGTMTMTGTMTGTDDDT
TDDDTTGTGTTTGTMTGTGTTTGTTTGTTTGTGTTTTTGTGTTTMTTTGTGTGTTTGTTTGTTTGTMTTTTTTTTTGTMTTTTTGTGTGTTTTTGTGTGTTTGTTTMTTTMTGTGTGTMTGTGTDDDT
TDDDGMGTGGMTMTGGGTMTGGMTMMMTGGGTGTGGGTGMMTGGGGGGGTGTGGGTGGGMGGGTMGGTGGGMGMGTGTGTMGGGGTMTGGGGGTGGGTGTGTMGGTGTGGGTGTMGGTGTGGGTDDDT
TDDDGTTTTTGTGTTTTTGTTTGTGTTTMTTTMTGTGTTTTTTTTTTTTTGTTTGTMTTTTTTTTTTTGTTTTTGTGTGTGTMTGTGTTTTTGTTTTTGTMTTTGTGTGTTTGTTTTTGTTTMTDDDT
TDDDGTMGGGGTMGGGGTGGMTGTGGGTGMGGGTGTGMGGMMMGGGMTGGGTGTGTGTGGGGMGMGGGGMGTMGMGGTGTGTGTGTMMGGGTGGMGMMMTMGMTMGGTMGGTMGGGGTMGMTGTDDDT
TDDDMTGTTTTTTTTTMTTTGTGTGTGTTTMTTTMTTTTTTTGTTTGTTTGTGTGTMTGTTTTTTTTTTTGTMTTTTTGTMTMTTTTTTTGTTTTTTTTTTTMTTTTTGTGTTTTTMTGTMTGTDDDT
TDDEMTMGGGGTGGGTGGGGGTGTGTGTMTMTMGGMGTGMMTGGGTGGGTGGGTGTGTGGGGGTGMMGGTGTMGGTGMGTMTGTMGGTGMGTGGGGGGGGGGGMGGMTGTMTMGGGMTMTGTGTEDDT
TDDDGTTTTTGTGTTTTTTTTTGTTTGTGTGTGTTTTTGTGTTTTTTTGTTTMTGTGTTTTTMTGTTTGTGTTTMTGTTTMTMTGTGTMTGTGTTTTTGTTTTTTTTTGTMTTTGTTTGTMTMTDDDT
TDDDMGGTGGMTGGGGMMMMGTMTGGGTGTGTMTGTGGGTMGMGGGGMMTGMGTMTGGGGGTGMGTGGGTGMGTGTGTMMGTGMMTGTGTMTGGMGMTMTGGGMGGMGGTMGGTGTMGGTGTGTDDDT
TDDDTTGTMTTTMTTTGTTTTTGTMTTTGTMTMTGTMTTTTTGTTTTTTTGTTTMTTTMTTTTTTTGTTTTTGTMTGTGTTTTTTTGTGTTTTTGTTTGTGTTTTTTTTTTTGTGTTTMTTTGTDDDT
TDDDGGGTMMGTGTGMMTGMGMGTGGGTGGGTGTGTGGGTGGGTGGGGGTGTGTGTGGMTGMMGGTMGGTGTMTMTMTGTGTMGGMGTGGMGGGGTGMMTGTGMMMMTMTGMGTMGGGGTMGMTDDDT
TDDDGTTTTTGTTTGTTTGTTTTTTTMTGTTTGTMTTTGTTTTTGTTTGTGTGTGTTTTTGTGTTTTTGTMTMTTTGTGTGTGTTTMTTTTTTTTTGTTTGTMTTTGTMTMTTTTTGTTTMTTTDDDT
TDDDGTMGGMGTGGGTGGGTGGGMGTGTGTGGMTMGGTGGGGGTGTGTGTGMMTGMGGGTMTGGGMMGMTMTGGGGGTGGMTMTGGGTMMMGGTGGGTGGGTGMGTGGGTGGGTMMGTGGMTGTDDDT
TDDDGTTTGTTTGTTTMTTTGTTTMTMTTTGTTTGTGTTTTTGTGTGTGTTTGTTTTTGTGTTTTTTTTTMTTTTTTTTTTTGTMTTTTTGTGTGTTTGTTTTTMTTTGTTTGTTTTTMTTTGTDDDT
TDDDGGGGGTGGGGGGGTGGGTGTGTGGGGMTGGGTGTMGGGGTGGGTMTGGMGGGGTMGGGMGGTGGGMMGMTGGGGGMMTMTGGMGGGGTGTMGMTMGMTGGMTGTGTGTGGGTGGGTGGMTDDDT
TDDDTTTTTTGTTTTTTTMTTTGTGTGTTTTTGTTTGTGTTTTTTTGTGTTTTTTTTTTTTTTTGTGTTTTTGTTTTTMTGTGTTTTTTTTTGTTTGTTTMTGTTTGTGTGTTTGTMTTTMTMTDDDT
TDDDMTGMMMGTGGGGGMGTGGMTGTGGGGGMGTFGGTGMGGGGGTGTMGGGGTMMGGGGGTGTMTGMGGMTGMGGGGGTMTGTGGGGGGGGMTFGMTGMMTGTGGGTGGGGGTGTGTGGGTGTDDDT
TDDDGTGTTTTTTTGTTTTTMTMTGTMTTTTTTTTTTTTTMTMTGTMTTTTTGTGTTTTTGTGTGTTTTTGTGTTTTTTTMTGTTTTTTTTTTTMTGTGTTTGTGTTTTTTTMTGTMTGTGTTTDDDT
TDDDGGGTGGMGMMGTGTMMGTMTGTGTGGGMGMGGGGGTGTMTGTMTGGGGGTGMMTGGGTGTMGGGMGGTGTMGGTGTMTGGGTGMGGGGGTGTGTMTMGGTGGMGGTGMGTGGGTGTGGGTDDDT
TDDDGTTTGTTTTTTTGTGTTTGTGTGTGTTTTTTTTTMTTTGTTTGTGTTTTTGTGTTTGTGTTTTTTTTTGTMTMTGTGTTTGTGTTTTTGTGTGTGTGTTTGTMTTTMTTTTTTTTTTTGTDDDT
TDDDGMMTGTGGGTGGGGGTMGMTGTGTGTMGGGGGGTGGGTMGGMGTGMGTGGMTGGMTMTMGGGGGGGMTGTMTGTMGGGGGGTMTMTGGGTGTGTGTMTMGGTGGGGMTGGGGGMGGGGMTDDDT
TDDDTTGTGTMTGTGTTTTTMTTTMTTTGTGTTTTTGTTTMTGTTTTTTTGTTTTTTTGTGTTTTTGTTTTTMTMTGTTTTTTTGTMTMTGTTTGTMTGTGTGTTTTTTTTTGTTTTTGTTTMTDDDT
TDDEMGGTGTGTMGMGGTGTGGGTGMGGGTMGMMMTGGGTGTGTGGGGGTGTGGGGMTGTGGGGGTGTGGMMMTMTMGGTGGGTGTGTMTGTGGGTGTGGGTGGGMGGGTGTGGGGGTGTMMGTEDDT
TDDDGTTTMTTTTTTTGTGTTTGTTTTTTTGTTTGTTTTTGTTTMTTTGTGTMTTTGTMTTTTTMTGTGTTTTTMTTTGTMTMTTTGTGTMTGTTTGTTTTTTTTTTTGTGTTTMTTTMTGTTTDDDT
TDDDGTMGGTGGGGGTGGGGGTGGGGGGGTMTMTGTGGMTGMMTGTGMGGGTGTGGGTGMGTMTGTGMGGGMGTGGGTMMGTGGGTGTGGGTGTMGMMGMGTGGMTGGGTMGMMGTMMMTGGGTDDDT
TDDDGTTTMTGTTTMTTTTTGTTTTTTTGTGTGTGTGTGTTTGTGTTTTTTTGTTTGTTTMTGTGTTTTTTTTTTTMTTTTTTTGTGTGTTTGTGTTTTTTTGTGTGTTTMTTTTTGTTTTTTTDDDT
TDDDGTGGGTGTGTMTGGGGGTGGGTGMMTMMGTGGMTGGGTMTGGMGGTGGGGGTGGGGGTGTGMGGGGMMGGGTGTGGGGGTGMGTGGGMGTGTGGGGGGGTGGGTGTMTMGGTGMGMMGGTDDDT
TDDDMTGTTTGTGTGTGTTTTTGTTTGTGTTTGTTTTTTTGTGTGTTTGTGTTTGTTTTTTTGTTTTTTTTTTTGTGTGTGTTTTTTTTTTTTTGTGTTTTTTTTTTTMTGTMTGTTTTTTTGTDDDT
TDDDMGGTMGGTMGMTGGMGGMMTGGGTGTMGGTGTGGGMGTGTMGGTGTGTGTMMMGGTMGGTGMGTMGGTGMGGGTMTGGGTGGGGGTGTGGGTGTMTGGGGGGGGMTGTGTGMMGMTGGGTDDDT
TDDDTTTTGTTTTTGTGTTTTTTTMTTTTTGTTTGTMTTTMTGTTTMTGTGTGTTTTTGTGTTTGTGTMTGTGTTTTTTTGTGTGTGTMTGTMTTTGTGTGTTTMTTTTTGTMTTTTTGTMTTTDDDT
TDDDGMGTGGGGGTGTGTMGGTGGGTMGGMMTGMGTGTGGGTGTGGGTGTGMGTMGGTGTGGGMGTGMGTGMGTMGGGGTGTGGGTGTGMMTGTGGGTMGGGGTGMGGMGGTMGGMGTGTGMMTDDDT
TDDDMTGTTTTTGTGTGTMTGTGTGTGTTTTTMTTTGTTTTTGTTTTTGTTTGTTTGTMTGTTTTTTTTTTTTTGTTTGTGTTTTTGTTTTTGTGTTTGTTTTTTTGTTTTTTTTTMTMTTTMTDDDT
TDDDGTGGGGGTGTGTGTGTGGGTGTGGGGMTGMGTMTGMGGGTGGGMGTGGGTGGGTGTGGMTGGGGGGMTMGMTMMGTGTGGGTGGGGMTGTGGGTGTGMGGGTGGGMMTGMGMGTGTGGGTDDDT
TDDDGTTTTTGTGTGTTTGTTTTTGTTTTTMTGTGTMTGTTTTTGTTTTTGTTTGTMTGTTTTTGTTTTTGTMTTTGTTTGTTTGTTTTTGTGTTTMTTTMTTTMTTTTTTTMTTTTTGTGTGTDDDT
TDDDGGGGGTGGGTGGMGMTMGGTMGGTMMMTMTGTGTMMGGGGMTGMGTGGMGGTGTMGGMGTGTMGGTGMGTGMGTMGGTMGGMMGGTGGGTMTGGGMGTGTMGGMGGGMGTGGGTGTMTGTDDDT
TDDDTTTTGTGTTTTTTTTTGTGTTTTTGTTTTTMTGTTTTTTTTTGTGTGTTTTTTTTTTTGTGTGTGTTTTTGTTTGTTTMTTTTTGTTTTTGTTTTTTTMTTTTTTTTTTTGTTTGTGTMTDDDT
TDDDGGGGGTGTMGGGGMGGGTGTGGGMGTGGGGMTGTGMGGGGGTMTMMGTMGGTGMMMGGGTMTGTGGGGMTGTGGGGMGMTGGMTGGGGGGGGMTGMMGGGMTGMGGGMGTGGGTGTGTGTDDDT
TDDDMTTTTTTTGTTTTTTTTTGTGTTTTTMTMTTTGTMTTTGTGTTTTTTTGTMTGTGTTTTTMTGTTTTTMTGTTTTTTTGTMTGTTTGTTTTTGTGTTTMTTTMTGTTTTTGTGTGTMTMTDDDT
TDDEGGGMGGGGGTGMGGGMGTGGGTMGGGMTMTMGGTGGGTGTGMMGGGGGGTGGMTGTGGGGMTMTGMGTGTMGGGGTGGGTGTGTGGGTGGGTMTGMGTGTMMGTGMGTMGGTGTGGGTGTEDDT
TDDDGTTTTTTTTTGTTTTTGTTTTTMTTTGTGTMTTTTTGTMTTTTTTTTTTTTTTTTTGTTTTTGTGTTTGTTTTTGTTTTTGTGTTTTTGTGTMTTTMTTTGTTTTTMTGTTTGTTTTTGTDDDT
TDDDMGGTGGMGGTGGGGMTGGMTGGMGGTMTMTGGGGMGGTGGGGGTGMGTGMMGGTGMGTMGGGMGGTGMGTMGMTGMGGGGMTMGGGMGGTMTGGGGMTGGGTMTGGGTMGMTMTGGGMMTDDDT
TDDDTTGTMTTTGTGTTTGTTTGTTTTTTTMTTTTTTTTTTTTTTTGTGTGTGTTTMTGTTTTTTTTTTTGTGTGTGTTTTTTTTTTTTTTTTTGTTTTTTTGTTTGTMTTTTTMTGTMTTTTTDDDT
TDDDMGGTGTGGGTMTMGMTGTGGGTGGGTMMGGGGMTGGGGMTMTGTGTGTMTGTGTGTMGMGGGGGMTGTGTGTGGMTMGGGMTGGGGGGMTGGGTMMGTGTGGGTMGMTMGGTGTGGGTGTDDDT
TDDDGTTTMTGTTTTTGTTTGTTTGTGTGTTTGTTTMTGTTTGTGTGTMTMTMTGTGTMTTTGTTTTTGTMTMTTTMTGTGTTTGTTTTTTTGTTTGTGTMTGTTTMTTTMTGTTTGTTTGTGTDDDT
TDDDMMGMMTMGMGGMGTGGMGGGGGGTMMGMMTGGGGGTMGGMGTGGMTGMGMGTGGGGGGMTGMGGMGGTGMMGGTGGGTGMGGGGGGGGGGGTGGGTMGMMGGGGMTGGGMGTGGGMGGMTDDDT
TDDDTTTTTTTTTTTTTTTTTTTTTTTTTTTTTTTTTTTTTTTTTTTTTTTTTTTTTTTTTTTTTTTTTTTTTTTTTTTTTTTTTTTTTTTTTTTTTTTTTTTTTTTTTTTTTTTTTTTTTTTTDDDT
TDDDEDDDDDDDDDDDDDDDEDDDDDDDDDDDDDDDEDDDDDDDDDDDDDDDEDDDDDDDDDDDDDDDEDDDDDDDDDDDDDDDEDDDDDDDDDDDDDDDEDDDDDDDDDDDDDDDEDDDDDDDDDDT
TDDDDDDDDDDDDDDDDDDDDDDDDDDDDDDDDDDDDDDDDDDDDDDDDDDDDDDDDDDDDDDDDDDDDDDDDDDDDDDDDDDDDDDDDDDDDDDDDDDDDDDDDDDDDDDDDDDDDDDDDDDDDDDT
TDDDDDDDDDDDDDDDDDDDDDDDDDDDDDDDDDDDDDDDDDDDDDDDDDDDDDDDDDDDDDDDDDDDDDDDDDDDDDDDDDDDDDDDDDDDDDDDDDDDDDDDDDDDDDDDDDDDDDDDDDDDDDDT
TTTTTTTTTTTTTTTTTTTTTTTTTTTTTTTTTTTTTTTTTTTTTTTTTTTTTTTTTTTTTTTTTTTTTTTTTTTTTTTTTTTTTTTTTTTTTTTTTTTTTTTTTTTTTTTTTTTTTTTTTTTTTTTT
