# name=Nexus Siege
# width=128
# height=128
# tile_size=32
# time_limit=180
# minion_cap=200
TTTTTTTTTTTTTTTTTTTTTTTTTTTTTTTTTTTTTTTTTTTTTTTTTTTTTTTTTTTTTTTTTTTTTTTTTTTTTTTTTTTTTTTTTTTTTTTTTTTTTTTTTTTTTTTTTTTTTTTTTTTTTTTT
TDDDDDDDDDDDDDDDDDDDDDDDDDDDDDDDDDDDDDDDDDDDDDDDDDDDDDDDDDDDDDDDDDDDDDDDDDDDDDDDDDDDDDDDDDDDDDDDDDDDDDDDDDDDDDDDDDDDDDDDDDDDDDDT
TDDDDDDDDDDDDDDDDDDDDDDDDDDDDDDDDDDDDDDDDDDDDDDDDDDDDDDDDDDDDDDDDDDDDDDDDDDDDDDDDDDDDDDDDDDDDDDDDDDDDDDDDDDDDDDDDDDDDDDDDDDDDDDT
TDDDEDDDDDDDDDDDDDDDEDDDDDDDDDDDDDDDEDDDDDDDDDDDDDDDEDDDDDDDDDDDDDDDEDDDDDDDDDDDDDDDEDDDDDDDDDDDDDDDEDDDDDDDDDDDDDDDEDDDDDDDDDDT
TDDEGCGGGGGGGGGGGGTTGGGGGGGGGGGGGGTTGGGGGGGGGGGGGGTTGGGGGGGGGGGGGGTTGGGGGGGGGGGGGGTTGGGGGGGGGGGGGGTTGGGGGGGGGGGGGGTTGGGGGGGGEDDT
TDDDGGGGGGGGGGGGGGTTGGGGGGGGGGGGGGTTGGGGGGGGGGGGGGGGGGGGGGGGGGGGGGTTGGGGGGGGGGGGGGTTGGGGGGGGGGGGGGTTGGGGGGGGGGGGGGTTGGGGGGGGDDDT
TDDDGGGGGGGGGGGGGGTTGGGGGGGGGGGGGGTTGGMMMMMMMMMMGGGGGGGGGGGGGGGGGGTTGGGGGGGGGGGGGGTTGGMMMMMMMMMMGGTTGGGGGGGGGGGGGGTTGGGGGGGGDDDT
TDDDGGGGGGGGGGGGGGTTGGGGGGGGGGGGGGTTGGMMMMMMMMMMGGGGGGGGGGGGGGGGGGTTGGGGGGGGGGGGGGTTGGMMMMMMMMMMGGTTGGGGGGGGGGGGGGTTGGGGGGGGDDDT
TDDDGGGGGGGGGGGGGGTTGGGGGGGGGGGGGGTTGGMMMMMMMMMMGGTTGGGGGGGGGGGGGGTTGGGGGGGGGGGGGGTTGGMMMMMMMMMMGGTTGGGGGGGGGGGGGGTTGGGGGGGGDDDT
TDDDGGGGGGGGGGGGGGTTGGGGLLGGGGGGGGTTGGMMMMMMMMMMGGTTGGGGGGGGGGGGGGTTGGGGGGGGGGGGGGTTGGMMMMMMMMMMGGGGGGGGGGGGGGGGGGTTGGGGGGGGDDDT
TDDDGGGGGGGGGGGGGGTTGGGGLLGGGGGGGGTTGGMMMMMMMMMMGGTTGGGGGGGGGGGGGGTTGGGGGGGGGGGGGGTTGGMMMMMMMMMMGGGGGGGGGGGGGGGGGGGGGGGGGGGGDDDT
TDDDGGGGGGGGGGGGGGTTGGGGGGGGGGGGGGTTGGMMMMMMMMMMGGTTGGGGGGGGGGGGGGTTGGGGGGGGGGGGGGTTGGMMMMMMMMMMGGGGGGGGGGGGGGGGGGGGGGGGGGGGDDDT
TDDDGGGGGGGGGGGGGGTTGGGGGGGGGGGGGGTTGGMMMMMMMMMMGGTTGGGGGGGGGGGGGGTTGGGGGGGGGGGGGGGGGGMMMMMMMMMMGGTTGGGGGGGGGGGGGGGGGGGGGGGGDDDT
TDDDGGGGGGGGGGGGGGTTGGGGGGGGGGGGGGTTGGMMMMMMMMMMGGTTGGGGGGGGGGGGGGGGGGGGGGGGGGGGGGGGGGMMMMMMMMMMGGTTGGGGGGGGGGGGGGTTGGGGGGGGDDDT
TDDDGGGGGGGGGGGGGGTTGGGGGGGGGGGGGGTTGGMMMMMMMMMMGGTTGGGGGGGGGGGGGGGGGGGGGGGGGGGGGGGGGGMMMMMMMMMMGGTTGGGGGGGGGGGGGGTTGGGGGGGGDDDT
TDDDGGGGGGGGGGGGGGGGGGGGGGGGGGGGGGTTGGMMMMMMMMMMGGTTGGGGGGGGGGGGGGGGGGGGGGGGGGGGGGTTGGMMMMMMMMMMGGTTGGGGGGGGGGGGGGTTGGGGGGGGDDDT
TDDDGGGGGGGGGGGGGGGGGGGGGGGGGGGGGGGGGGGGGGGGGGGGGGTTGGGGGGGGGGGGGGTTGGGGGGGGGGGGGGTTGGGGGGGGGGGGGGTTGGGGGGGGGGGGGGTTGGGGGGGGDDDT
TDDDGGGGGGGGGGGGGGGGGGGGGGGGGGGGGGGGGGGGGGGGGGGGGGTTGGGGGGGGGGGGGGTTGGGGGGGGGGGGGGTTGGGGGGGGGGGGGGTTGGGGGGGGGGGGGGTTGGGGGGGGDDDT
TDDDTTTTTTTGGGTTTTTTTTGGGTTTTTTTTTGGTTTTTTTTTGGGTTTTTTTTTGGGTTTTTTTTTTTTTTTTTTTGGGTTTTTTTTTTTTGGGTTTTTTTTTGGGTTTTTTTTTGGGTTTDDDT
TDDDTTTTTTTGGGTTTTTTTTFGGTTTTTTTTTTTTTTTTTTTTGGGTTTTTTTTTGGGTTTTTTTTTTTTTTTTTTTGGGTTTTTTTTTTTTGGGTTTTTTTTTGGGTTTTTTTTTGGGTTTDDDT
TDDEGGGGGGGGGGGGGGTTGGGGGGGGGGGGGGTTGGGGGGGGGGGGGGTTGGGGGGGGGGGGGGTTGGGGGGGGGGGGGGTTGGGFGGGGGGGGGGTTGGGGGGGGGGGGGGTTGGGGGGGGEDDT
TDDDGGGGGGGGGGGGGGTTGGGGGGGGGGGGGGTTGGGGGGGGGGGGGGGGGGGGGGGGGGGGGGTTGGGGGGGGGGGGGGTTGGGGGGGGGGGGGGTTGGGGGGGGGGGGGGTTGGGGGGGGDDDT
TDDDGGGGGGGGGGGGGGGGGGMMMMMMMMMMGGGGGGGGGGGGGGGGGGGGGGGGGGGGGGGGGGTTGGMMMMMMMMMMGGTTGGGGGGGGGGGGGGTTGGGGGGGGGGGGGGTTGGGGGGGGDDDT
TDDDGGGGGGGGGGGGGGGGGGMMMMMMMMMMGGGGGGGGGGGGGLLGGGGGGGGGGGGGGGGGGGTTGGMMMMMMMMMMGGTTGGGGGGGGGGGGGGGGGGGGGGGGGGGGGGTTGGGGGGGGDDDT
TDDDGGGGGGGGGGGGGGGGGGMMMMMMMMMMGGGGGGGGGGGGGLLGGGTTGGGGGGGGGGGGGGGGGGMMMMMMMMMMGGTTGGGGGGGGGGGGGGGGGGGGGGGGGGGGGGTTGGGGGGGGDDDT
TDDDGGGGGGGGGGGGGGTTGGMMMMMMMMMMGGTTGGGGGGGGGGGGGGTTGGGGGGGGGGGGGGGGGGMMMMMMMMMMGGTTGGGGGGGGGGGGGGGGGGGGGGGGGGGGGGTTGGGGGGGGDDDT
TDDDGGGGGGGGGGGGGGTTGGMMMMMMMMMMGGTTGGGGGGGGGGGGGGTTGGGGGGGGGGGGGGGGGGMMMMMMMMLLGGTTGGGGGGGGGGGGGGTTGGGGGGGGGGGGGGGGGGGGGGGGDDDT
TDDDGGGGGGGGGGGGGGTTGGMMMMMMMMMMGGTTGGGGGGGGGGGGGGTTGGGGGGGGGGGGGGTTGGMMMMMMMMLLGGTTGGGGGGGGGGGGGGTTGGGGGGGGGGGGGGGGGGGGGGGGDDDT
TDDDGGGGGGGGGGGGGGTTGGMMMMMMMMMMGGTTGGGGGGGGGGGGGGTTGGGGGGGGGGGGGGTTGGMMMMMMMMMMGGTTGGGGGGGGGGGGGGTTGGGGGGGGGGGGGGGGGGGGGGGGDDDT
TDDDGGGGGGGGGGGGGGTTGGMMMMMMMMMMGGTTGGGGGGGGGGGGGGTTGGGGGGGGGGGGGGTTGGMMMMMMMMMMGGTTGGGGGGGGGGGGGGTTGGGGGGGGGGGGGGTTGGGGGGGGDDDT
TDDDGGGGGGGGGGGGGGTTGGMMMMMMMMMMGGTTGGGGGGGGGGGGGGTTGGGGGGGGGGGGGGTTGGMMMMMMMMMMGGGGGGGGGGGGGGGGGGTTGGGGGGGGGGGGGGTTGGGGGGGGDDDT
TDDDGGGGGGGGGGGGGGTTGGMMMMMMMMMMGGTTGGGGGGGGGGGGGGTTGGGGGGGGGGGGGGTTGGMMMMMMMMMMGGGGGGGGGGGGGGGGGGTTGGGGGGGGGGGGGGTTGGGGGGGGDDDT
TDDDGGGGGGGGGGGGGGTTGGGGGGGGGGGGGGTTGGGGGGGGGGGGGGTTGGGGGGGGGGGGGGTTGGGGGGGGGGGGGGGGGGGGGGGGGGGGGGTTGGGGGGGGGGGGGGTTGGGGGGGGDDDT
TDDDGGGGGGGGGGGGGGTTGGGGGGGGGGGGGGTTGGGGGGGGGGGGGGTTGGGGGGGGGGGGGGTTGGGGGGGGGGGGGGTTGGGGGGGGGGGGGGTTGGGGGGGGGGGGGGTTGGGGGGGGDDDT
TDDDTTTTTTTTTTTTGGGTTTGGGTTTTTTTTTTTTGGGTTTTTTTTTTTTTTTTTTTTTTTGGGTTTTTTGGGTTTTTTTTTTTTTTGGGTTTTTTTTTTGGGTTTTTTTTTTTTTGGGTTTDDDT
TDDDTTTTTTTTTTTTGGGTTTGGGTTTTTTTTTTTTGGGTTTTTTTTTTTTTTTTTTTTTTTGGGTTTTTTGGGTTTTTTTTTTTTTTGGGTTTTTTTTTTGGGTTTTTTTTTTTTTGGGTTTDDDT
TDDEGGGGGGGGGGGGGGTTGGGGGGGGGGGGGGTTGGGGGGGGGGGGGGTTGFGGGGGGGGGGGGTTGGGGGGGGGGGGGGTTGGGGGGGGGGGGGGTTGGGGGGGGGGGGGGTTGGGGGGGGEDDT
TDDDGGGGGGGGGGGGGGGGGGGGGGGGGGGGGGTTGGGGGGGGGGGGGGTTGGGGGGGGGGGGGGTTGGGGGGGGGGGGGGTTGGGGGGGGGGGGGGTTGGGGGGGGGGGGGGTTGGGGGGGGDDDT
TDDDGGMMMMMMMMMMGGGGGGGGGGGGGGGGGGTTGGGGGGGGGGGGGGGGGGMMMMMMMMMMGGTTGGGGGGGGGGGGGGTTGGGGGGGGGGGGGGTTGGMMMMMMMMMMGGTTGGGGGGGGDDDT
TDDDGGMMMMMMMMMMGGGGGGGGGGGGGGGGGGTTGGGGGGGGGGGGGGGGGGMMMMMMMMMMGGTTGGGGGGGGGGGGGGTTGGGGGGGGGGGGGGTTGGMMMMMMMMMMGGTTGGGGGGGGDDDT
TDDDGGMMMMMMMMMMGGTTGGGGGGGGGGGGGGTTGGGGGGGGGGGGGGGGGGMMMMMMMMMMGGTTGGGGGGGGGGGGGGTTGGGGGGGGGGGGGGGGGGMMMMMMMMMMGGTTGGGGGGGGDDDT
TDDDGGMMMMMMMMMMGGTTGGGGGGGGGGGGGGTTGGGGGGGGGGGGGGTTGGMMMMMMMMMMGGTTGGGGGGGGGGGGGGGGGGGGGGGGGGGGGGGGGGMMMMMMMMMMGGTTGGGGGGGGDDDT
TDDDGGMMMMMMMMMMGGTTGGGGGGGGGGGGGGTTGGGGGGGGGGGGGGTTGGMMMMMMMMMMGGTTGGGGGGGGGGGGGGGGGGGGGGGGGGGGGGGGGGMMMMMMMMMMGGTTGGGGGGGGDDDT
TDDDGGMMMMMMMMMMGGTTGGGGGGGGGGGGGGTTGGGGGGGGGGGGGGTTGGMMMMMMMMMMGGTTGGGGGGGGGGGGGGGGGGGGGGGGGGGGGGTTGGMMMMMMMMMMGGTTGGGGGGGGDDDT
TDDDGGMMMMMMMMMMGGTTGGGGGGGGGGGGGGTTGGGGGGGGGGGGGGTTGGMMMMMMMMMMGGTTGGGGGGGGGGGGGGTTGGGGGGGGGGGGGGTTGGMMMMMMMMMMGGTTGGGGGGGGDDDT
TDDDGGMMMMMMMMMMGGTTGGGGGGGGGGGGGGTTGGGGGGGGGGGGGGTTGGMMMMMMMMMMGGTTGGGGGGGGGGGGGGTTGGGGGGGGGGGGGGTTGGMMMMMLLMMMGGTTGGGGGGGGDDDT
TDDDGGMMMMMMMMMMGGTTGGGGGGGGGGGGGGTTGGGGGGGGGGGGGGTTGGMMMMMMMMMMGGTTGGGGGGGGGGGGGGTTGGGGGGLLGGGGGGTTGGMMMMMLLMMMGGGGGGGGGGGGDDDT
TDDDGGMMMMMMMMMMGGTTGGGGGGGGGGGGGGGGGGGGGGGGGGGGGGTTGGMMMMMMMMMMGGTTGGGGGGGGGGGGGGTTGGGGGGLLGGGGGGTTGGMMMMMMMMMMGGGGGGGGGGGGDDDT
TDDDGGGGGGGGGGGGGGTTGGGGGGGGGGGGGGGGGGGGGGGGGGGGGGTTGGGGGGGGGGGGGGGGGGGGGGGGGGGGGGTTGGGGGGGGGGGGGGTTGGGGGGGGGGGGGGGGGGGGGGGGDDDT
TDDDGGGGGGGGGGGGGGTTGGGGGGGGGGGGGGGGGGGGGGGGGGGGGGTTGGGGGGGGGGGGGGGGGGGGGGGGGGGGGGTTGGGGGGGGGGGGGGTTGGGGGGGGGGGGGGTTGGGGGGGGDDDT
TDDDTTGGGTTTTTTTTTTTTTTTTTTGGGTTTTTTTTTTTGGGTTTTTTTTTTTTTTTTGGGTTTGGTTTTTTTTTTTGGGTTTTTTTTGGGTTTTTTTTTTGGGTTTTTTTTTTTTTGGGTTDDDT
TDDDTTGGGTTTTTTTTTTTTTTTTTTGGGTTTTTTTTTTTGGGTTTTTTTTTTTTTTTTGGGTTTTTTTTTTTTTTTTGGGTTTTTTTTGGGTTTTTTTTTTGGGTTTTTTTTTTTTTGGGTTDDDT
TDDEGGGGGGGGGGGGGGTTGGGGGGGGGGGGGGTTGGGGGGGGGGGGGGTTGGGGGGGGGGGGGGTTGGGGGGGGGGGGGGTTGGGGGGGGGGGGGGTTGGGGGGGGGGGGGGTTGGGGGGGGEDDT
TDDDGGGGGGGGGGGGGGTTGGGGGGGGGGGGGGTTGGGGGGGGGGGGGGTTGGGGGGGGGGGGGGTTGGGGGGGGGGGGGGGGGGGGGGGGGGGGGGTTGGGGGGGGGGGGGGTTGGGGGGGGDDDT
TDDDGGGGGGGGGGGGGGTTGGGGGGGGGGGGGGTTGGMMMMMMMMMMGGTTGGGGGGGGGGGGGGTTGGGGGGGGGGGGGGGGGGMMMMMMMMMMGGTTGGGGGGGGGGGGGGTTGGGGGGGGDDDT
TDDDGGGGGGGGGGGGGGTTGGGGGGGGGGGGGGTTGGMMMMMMMMMMGGTTGGGGGGGGGGGGGGTTGGGGGGGGGGGGGGGGGGMMMMMMMMMMGGTTGGGGGGGGGGGGGGTTGGGGGGGGDDDT
TDDDGGGGGGGGGGGGGGTTGGGGGGGGGGGGGGTTGGMMMMMMMMMMGGGGGGGGGGGGGGGGGGTTGGGGGGGGGGGGGGTTGGMMMMMMMMMMGGTTGGGGGGGGGGGGGGTTGGGGGGGGDDDT
TDDDGGGGGGGGGGGGGGTTGGGGGGGGGGGGGGTTGGMMMMMMMMMMGGGGGGGGGGGGGGGGGGTTGGGGGGGGGGGGGGTTGGMMMMMMMMMMGGTTGGGGGGGGGGGGGGGGGGGGGGGGDDDT
TDDDGGGGGGGGGGGGGGTTGGGGGGGGGGGGGGTTGGMMMMMMMMMMGGGGGGGGGGGGGGGGGGTTGGGGGGGGGGGGGGTTGGMMMMMMMMMMGGGGGGGGGGGLLGGGGGGGGGGGGGGGDDDT
TDDDGGGGGGGGGGGGGGTTGGGGGGGGGGGGGGTTGGMMMMMMMMMMGGTTGGGGGGGGGGGGGGTTGGGGGGGGGGGGGGTTGGMMMMMMMMMMGGGGGGGGGGGLLGGGGGGGGGGGGGGGDDDT
TDDDGGGGGGGGGGGGGGTTGGGGGGGGGGGGGGTTGGMMMMMMMMMMGGTTGGGGGGGGGGGGGGTTGGGGGGGGGGGGGGTTGGMMMMMMMMMMGGGGGGGGGGGGGGGGGGTTGGGGGGGGDDDT
TDDDGGGGGGGGGGGGGGTTGGGGGGGGGGGGGGTTGGMMMMMMMMMMGGTTGGGGGGGGGGGGGGTTGGGGGGGGGGGGGGTTGGMMMMMMMMMMGGTTGGGGGGGGGGGGGGTTGGGGGGGGDDDT
TDDDGGGGGGGGGGGGGGTTGGGGGGGGGGGGGGTTGGMMMMMMMMMMGGTTGGGGGGGGGGGGGGTTGGGGGGGGGGGGGGTTGGMMMMMMMMMMGGTTGGGGGGGGGGGGGGTTGGGGGGGGDDDT
TDDDGGGGGGGGGGGGGGTTGGGGGGGGGGGGGGTTGGMMMMMMMMMMGGTTGGGGGGGGGGGGGGGGGGGGGGGGGGGGGGTTGGMMMMMMMMMMGGTTGGGGGGGGGGGGGGTTGGGGGGGGDDDT
TDDDGGGGGGGGGGGGGGGGGGGGGGGGGGGGGGGGGGGGGGGGGGGGGGTTGGGGGGGGGGGGGGGGGGGGGGGGGGGGGGTTGGGGGGGGGGGGGGTTGGGGGGGGGGGGGGTTGGGGGGGGDDDT
TDDDGGGGGGGGGGGGGGGGGGGGGGGGGGGGGGGGGGGGGGGGGGGGGGTTGGGGGGGGGGGGGGGGGGGGGGGGGGGGGGTTGGGGGGGGGGGGGGTTGGGGGGGGGGGGGGTTGGGGGGGGDDDT
TDDDTTTTTTGGGTTTTTGGTTTTGGGTTTTTTTGGTTTTTTTTTTTGGGTTTTTTTGGGTTTTTTTTTTTTTTTTTTTTGGGTTTTTTTTTTTTGGGTTTTTTTTTTTTTGGGTTTGGGTTTTDDDT
TDDDTTTTTTGGGTTTTTTTTTTTGGGTTTTTTTTTTTTTTTTTTTTGGGTTTTTTTGGGTTTTTTTTTTTTTTTTTTTTGGGTTTTTTTTTTTTGGGTTTTTTTTTTTTTGGGTTTGGGTTTTDDDT
TDDEGGGGGGGGGGGGGGTTGGGGGGGGGGGGGGTTGGGGGGGGGGGGGGTTGGGGGGGGGGGGGGTTGGGGGGGGGGGGGGTTGGGGGGGGGGGGGGTTGGGGGGGGGGGGGGTTGGGGGGGGEDDT
TDDDGGGGGGGGGGGGGGTTGGGGGGGGGGGGGGTTGGGGGGGGGGGGGGTTGGGGGGGGGGGGGGTTGGGGGGGGGGGGGGTTGGGGGGGGGGGGGGTTGGGGGGGGGGGGGGGGGGGGGGGGDDDT
TDDDGGGGGGGGGGGGGGTTGGMMMMMMMMMMGGTTFGGGGGGGGGGGGGTTGGGGGGGGGGGGGGTTGGFMMMMMMMMMGGTTGGGGGGGGGGGGGGGGGGGGGGGGGGGGGGGGGGGGGGGGDDDT
TDDDGGGGGGGGGGGGGGTTGGMMMMMMMMMMGGTTGGGGGGGGGGGGGGTTGGGGGGGGGGGGGGTTGGMMMMMMMMMMGGGGGGGGGGGGGGGGGGGGGGGGGGGGGGGGGGGGGGGGGGGGDDDT
TDDDGGGGGGGGGGGGGGTTGGMMMMMMMMMMGGTTGGGGGGGGGGGGGGGGGGGGGGGGGGGGGGTTGGMMMMMMMMMMGGGGGGGGGGGGGGGGGGGGGGGGGGGGGGGGGGTTGGGGGGGGDDDT
TDDDGGGGGGGGGGGGGGGGGGMMMMMMMMMMGGTTGGGGGGGGGGGGGGGGGGGGGGGGGGGGGGTTGGMMMMMMMMMMGGGGGGGGGGGGGGGGGGTTGGGGGGGGGGGGGGTTGGGGGGGGDDDT
TDDDGGGGGGGGGGGGGGGGGGMMMMMMMMMMGGTTGGGGGGGGGGGGGGGGGGGGGGGGGGGGGGTTGGMMMMMMMMMMGGTTGGGGGGGGGGGGGGTTGGGGGGGGGGGGGGTTGGGGGGGGDDDT
TDDDGGGGGGGGGGGGGGGGGGMMMMMMMMMMGGTTGGGGGGGGGGGGGGTTGGGGGGGGGGGGGGTTGGMMMMMMMMMMGGTTGGGGGGGGGGGGGGTTGGGGGGGGGGGGGGTTGGGGGGGGDDDT
TDDDGGGGGGGGGGGGGGTTGGMMMMMMMMMMGGTTGGGGGGGGGGGGGGTTGGGGGGGGGGGGGGTTGGMMMMMMMMMMGGTTGGGGGGGGGGGGGGTTGGGGGGGGGGGGGGTTGGGGGGGGDDDT
TDDDGGGGGGGGGGGGGGTTGGMMMMMMMMMMGGGGGGGGGGGGGGGGGGTTGGGGGGGGGGGGGGTTGGMMMMMMMMMMGGTTGGGGGGGGGGGGGGTTGGGGGGGGGGGGGGTTGGGGGGGGDDDT
TDDDGGGGGGGGGGGGGGTTGGMMMMMMMMMMGGGGGGGGGGGGGGGGGGTTGGGGGGGGGGGGGGTTGGMMMMMMMMMMGGTTGGGGGGGGGGGGGGTTGGGGGGGGGGGGGGTTGGGGGGGGDDDT
TDDDGGGGGGGGGGGGGGTTGGMMMMMMMMMMGGGGGGGGGGGGGGGGGGTTGGGGGGGGGGGGGGTTGGMMMMMMMMMMGGTTGGGGGGGGGGGGGGTTGGGGGGGGGGGGGGTTGGGGGGGGDDDT
TDDDGGGGGGGGGGGGGGTTGGGGGGGGGGGGGGTTGGGGGGGGGGGGGGTTGGGGGGGGGGGGGGGGGGGGGGGGGGGGGGTTGGGGGGGGGGGGGGTTGGGGGGGGGGGGGGTTGGGGGGGGDDDT
TDDDGGGGGGGGGGGGGGTTGGGGGGGGGGGGGGTTGGGGGGGGGGGGGGTTGGGGGGGGGGGGGGGGGGGGGGGGGGGGGGTTGGGGGGGGGGGGGGTTGGGGGGGGGGGGGGTTGGGGGGGGDDDT
TDDDTTTTTTTTTTGGGTTTTTTTTTTTTTTGGGTTTTTGGGTTTTTTTTTTTTTTTTTTTGGGTTGGTTTTTTTTTTTTGGGTTTTTGGGTTTTTTTTTTTTGGGTTTTTTTTTTTTTTGGGTDDDT
TDDDTTTTTTTTTTGGGTTTTTTTTTTTTTTGGGTTTTTGGGTTTTTTTTTTTTTTTTTTTGGGTTTTTTTTTTTTTTTTGGGTTTTTGGGTTTTTTTTTTTTGGGTTTTTTTTTTTTTTGGGTDDDT
TDDEGGGGGGGGGGGGGGTTGGGGGGGGGGGGGGTTGGGGGGGGGGGGGGTTGGGGGGGGGGGGGGTTGGGGGGGGGGGGGGTTGGGGGGGGGGGGGGTTGGGGGGGGGGGGGGTTGGGGGGGGEDDT
TDDDGGGGGGGGGGGGGGTTGGGGGGGGGGGGGGTTGGGGGGGGGGGGGGTTGGGGGGGGGGGGGGTTGGGGGGGGGGGGGGTTGGGGGGGGGGGGGGTTGGGGGGGGGGGGGGTTGGGGGGGGDDDT
TDDDGGMMMMMMMMMMGGTTGGGGGGGGGGGGGGGGGGGGGGGGGGGGGGTTGGMMMMMMMMMMGGTTGGGGGGGGGGGGGGTTGGGGGGGGGGGGGGGGGGMMMMMMMMMMGGTTGGGGGGGGDDDT
TDDDGGMMMMMMMMMMGGTTGGGGGGGGGGGGGGGGGGGGGGGGGGGGGGTTGGMMMMMMMMMMGGTTGGGGGGGGGGGGGGTTGGGGGGGGGGGGGGGGGGMMFMMMMMMMGGTTGGGGGGGGDDDT
TDDDGGMMMMMMMMMMGGGGGGGGGGGGGGGGGGGGGGGGGGGGGGGGGGTTGGMMMMMMMMMMGGTTGGGGGGGGGGGGGGTTGGGGGGGGGGGGGGGGGGMMMMMMMMMMGGTTGGGGGGGGDDDT
TDDDGGMMMMMMMMMMGGGGGGGGGGGGGGGGGGTTGGGGGGGGGGGGGGTTGGMMMMMMMMMMGGTTGGGGGGGGGGGGGGTTGGGGGGGGGGGGGGTTGGMMMMMMMMMMGGTTGGGGGGGGDDDT
TDDDGGMMMMMMMMMMGGGGGGGGGGGGGGGGGGTTGGGGGGGGGGGGGGTTGGMMMMMMMMMMGGTTGGGGGGGGGGGGGGTTGGGGGGGGGGGGGGTTGGMMMMMMMMMMGGTTGGGGGGGGDDDT
TDDDGGMMMMMMMMMMGGTTGGGGGGGGGGGGGGTTGGGGGGGGGGGGGGTTGGMMMMMMMMMMGGTTGGGGGGGGGGGGGGTTGGGGGGGGGGGGGGTTGGMMMMMMMMMMGGTTGGGGGGGGDDDT
TDDDGGMMMMMMMMMMGGTTGGGGGGGGGGGGGGTTGGGGGGGGGGGGGGTTGGMMMMMMMMMMGGTTGGGGGGGGGGGGGGTTGGGGGGGGGGGGGGTTGGMMMMMMMMMMGGTTGGGGGGGGDDDT
TDDDGGMMMMMMMMMMGGTTGGGGGGGGGGGGGGTTGGGGGGGGGGGGGGGGGGMMMMMMMMMMGGGGGGGGGGGGGGGGGGTTGGGGGGGGGGGGGGTTGGMMMMMMMMMMGGTTGGGGGGGGDDDT
TDDDGGMMMMMMMMMMGGTTGGGGGGGGGGGGGGTTGGGGGGGGGGGGGGGGGGMMMMMMMMMMGGGGGGGGGGGGGGGGGGTTGGGGGGGGGGGGGGTTGGMMMMMMMMMMGGTTGGGGGGGGDDDT
TDDDGGMMMMMMMMMMGGTTGGGGGGGGGGGGGGTTGGGGGGGGGGGGGGGGGGMMMMMMMMMMGGGGGGGGGGGGGGGGGGTTGGGGGGGGGGGGGGTTGGMMMMMMMMMMGGTTGGGGGGGGDDDT
TDDDGGGGGGGGGGGGGGTTGGGGGGGGGGGGGGTTGGGGGGGGGGGGGGTTGGGGGGGGGGGGGGTTGGGGGGGGGGGGGGGGGGGGGGGGGGGGGGTTGGGGGGGGGGGGGGGGGGGGGGGGDDDT
TDDDGGGGGGGGGGGGGGTTGGGGGGGGGGGGGGTTGGGGGGGGGGGGGGTTGGGGGGGGGGGGGGTTGGGGGGGGGGGGGGGGGGGGGGGGGGGGGGTTGGGGGGGGGGGGGGGGGGGGGGGGDDDT
TDDDTTTTTTTGGGTTTTTTTTTTTGGGTTTTTTTTTTTTTTTTTTTGGGTTTTTTTTTTTTTTGGGTTTTTTTTTTGGGTTGGTTTTGGGTTTTTTTTTTTTTTTTTTTTGGGGGTTTGGGTTDDDT
TDDDTTTTTTTGGGTTTTTTTTTTTGGGTTTTTTTTTTTTTTTTTTTGGGTTTTTTTTTTTTTTGGGTTTTTTTTTTGGGTTTTTTTTGGGTTTTTTTTTTTTTTTTTTTTGGGTTTTTGGGTTDDDT
TDDEGGGGGGGGGGGGGGTTGGGGGGGGGGGGGGTTGGGGGGGGGGGGGGTTGGGGGGGGGGGGGGTTGGGGGGGGGGGGGGTTGGGGGGGGGGGGGGTTGGGGGGGGGGGGGGTTGGGGGGGGEDDT
TDDDGGGGGGGGGGGGGGTTGGGGGGGGGGGGGGTTGGGGGGGGGGGGGGTTGGGGGGGGGGGGGGTTGGGGGGGGGGGGGGTTGGGGGGGGGGGGGGTTGGGGGGGGGGGGGGTTGGGGGGGGDDDT
TDDDGGGGGGGGGGGGGGTTGGGGGGGGGGGGGGTTGGMMMMMMMMMMGGTTGGGGGGGGGGGGGGTTGGGGGGGGGGGGGGTTGGMMMMMMMMMMGGTTGGGGGGGGGGGGGGTTGGGGGGGGDDDT
TDDDGGGGGGGGGGGGGGTTGGGGGGGGGGGGGGTTGGMMMMMMMMMMGGTTGGGGGGGGGGGGGGTTGGGGGGGGGGGGGGTTGGMMMMMMMMMMGGTTGGGGGGGGGGGGGGTTGGGGGGGGDDDT
TDDDGGGGGGGGGGGGGGGGGGGGGGGGGGGGGGTTGGMMMMMMMMMMGGTTGGGGGGGGGGGGGGTTGGGGGGGGGGGGGGTTGGMMMMMMMMMMGGTTGGGGGGGGGGGGGGTTGGGGGGGGDDDT
TDDDGGGGGGGGGGGGGGGGGGGGGGGGGGGGGGTTGGMMMMMMMMMMGGTTGGGGGGGGGGGGGGTTGGGGGGGGGGGGGGTTGGMMMMMMMMMMGGTTGGGGGGGGGGGGGGTTGGGGGGGGDDDT
TDDDGGGGGGGGGGGGGGGGGGGGGGGGGGGGGGTTGGMMMMMMMMMMGGTTGGGGGGGGGGGGGGTTGGGGGGGGGGGGGGTTGGMMMMMMMMMMGGTTGGGGGGGGGGGGGGTTGGGGGGGGDDDT
TDDDGGGGGGGGGGGGGGTTGGGGGGGGGGGGGGTTGGMMMMMMMMMMGGTTGGGGGGGGGGGGGGGGGGGGGGGGGGGGGGGGGGMMMMMMMMMMGGGGGGGGGGGGGGGGGGTTGGGGGGGGDDDT
TDDDGGGGGGGGGGGGGGTTGGGGGGGGGGGGGGTTGGMMMMMMMMMMGGTTGGGGGGGGGGGGGGGGGGGGGGGGGGGGGGGGGGMMMMMMMMMMGGGGGGGGGGGGGGGGGGGGGGGGGGGGDDDT
TDDDGGGGGGGGGGGGGGTTGGGGGGGGGGGGGGTTGGMMMMMMMMMMGGTTGGGGGGGGGGGGGGGGGGGGGGGGGGGGGGGGGGMMMMMMMMMMGGGGGGGGGGGGGGGGGGGGGGGGGGGGDDDT
TDDDGGGGGGGGGGGGGGTTGGGGGGGGGGGGGGGGGGMMMMMMMMMMGGGGGGGGGGGGGGGGGGTTGGGGGGLLGGGGGGTTGGMMMMMMMMMMGGTTGGGGGGGGGGGGGGGGGGGGGGGGDDDT
TDDDGGGGGGGGGGGGGGTTGGGGGGGGGGGGGGGGGGMMMMMMMMMMGGGGGGGGGGGGGGGGGGTTGGGGGGLLGGGGGGTTGGMMMMMMMMMMGGTTGGGGGGGGGGGGGGTTGGGGGGGGDDDT
TDDDGGGGGGGGGGGGGGTTGGGGGGGGGGGGGGGGGGGGGGGGGGGGGGGGGGGGGGGGGGGGGGTTGGGGGGGGGGGGGGTTGGGGGGGGGGGGGGTTGGGGGGGGGGGGGGTTGGGGGGGGDDDT
TDDDGGGGGGGGGGGGGGTTGGGGGGGGGGGGGGTTGGGGGGGGGGGGGGTTGGGGGGGGGGGGGGTTGGGGGGGGGGGGGGTTGGGGGGGGGGGGGGTTGGGGGGGGGGGGGGTTGGGGGGGGDDDT
TDDDTGGGTTTTTTTTTTTTTTTTGGGTTTTTTTTTTGGGTTTTTTTTTTTTTTTTTTGGGTTTTTTTTTTTTTTGGGTTTTTTTTTTTGGGTTTTTTTTTTGGGTTTTTTTTTTTTTGGGTTTDDDT
TDDDTGGGTTTTTTTTTTTTTTTTGGGTTTTTTTTTTGGGTTTTTTTTTTTTTTTTTTGGGTTTTTTTTTTTTTTGGGTTTTTTTTTTTGGGTTTTTTTTTTGGGTTTTTTTTTTTTTGGGTTTDDDT
TDDEGGGGGGGGGGGGGGTTGGGGGGGGGGGGGGTTGGGGGGGGGGGGGGTTGGGGGGGGGGGGGGTTGGGGGGGGGGGGGGTTGGGGGGGGGGGGGGTTGGGGGGGGGGGGGGTTGGGGGGGGEDDT
TDDDGGGGGGGGGGGGGGTTGGGGGGGGGGGGGGTTGGGGGGGGGGGGGGGGGGGGGGGGGGGGGGTTGGGGGGGGGGGGGGTTGGGGGGGGGGGGGGGGGGGGGGGGGGGGGGGGGGGGGGGGDDDT
TDDDGGGGGGGGGGGGGGGGGGGGGGGGGGGGGGTTGGGGGGGGGGGGGGGGGGGGGGGGGGGGGGGGGGGGGGGGGGGGGGTTGGGGGGGGGGGGGGGGGGGGGGGGGGGGGGGGGGGGGGGGDDDT
TDDDGGGGGGGGGGGGGGGGGGGGGGGGGGGGGGTTGGGGGGGGGGGGGGGGGGGGGGGGGGGGGGGGGGGGGGGGGGGGGGGGGGGGGGGGGGGGGGGGGGGGGGGGGGGGGGGGGGGGGGGGDDDT
TDDDGGGGGGGGGGGGGGGGGGGGGGGGGGGGGGGGGGGGGGGGGGGGGGTTGGGGGGGGGGGGGGGGGGGGGGGGGGGGGGGGGGGGGGGGGGGGGGTTGGGGGGGGGGGGGGTTGGGGGGGGDDDT
TDDDGGGGGGGGGGGGGGTTGGGGGGGGGGGGGGGGGGGGGGGGGGGGGGTTGGGGGGGGGGGGGGTTGGGGGGGGGGGGGGGGGGGGGGGGGGGGGGTTGGGGGGGGGGGGGGTTGGGGGGGGDDDT
TDDDGGGGGGGGGGGGGGTTGGGGGGGGGGGGGGGGGGGGGGGGGGGGGGTTGGGGGGGGGGGGGGTTGGGGGGGGGGGGGGTTGGGGGGGGGGGGGGTTGGGGGGGGGGGGGGTTGGGGGGGGDDDT
TDDDGGGGGGGGGGGGGGTTGGGGGGGGGGGGGGTTGGGGGGGGGGGGGGTTGGGGGGGGGGGGGGTTGGGGGGGGGGGGGGTTGGGGGGGGGGGGGGTTGGGGGGGGGGGGGGTTGGGGGGGGDDDT
TDDDEDDDDDDDDDDDDDDDEDDDDDDDDDDDDDDDEDDDDDDDDDDDDDDDEDDDDDDDDDDDDDDDEDDDDDDDDDDDDDDDEDDDDDDDDDDDDDDDEDDDDDDDDDDDDDDDEDDDDDDDDDDT
TDDDDDDDDDDDDDDDDDDDDDDDDDDDDDDDDDDDDDDDDDDDDDDDDDDDDDDDDDDDDDDDDDDDDDDDDDDDDDDDDDDDDDDDDDDDDDDDDDDDDDDDDDDDDDDDDDDDDDDDDDDDDDDT
TDDDDDDDDDDDDDDDDDDDDDDDDDDDDDDDDDDDDDDDDDDDDDDDDDDDDDDDDDDDDDDDDDDDDDDDDDDDDDDDDDDDDDDDDDDDDDDDDDDDDDDDDDDDDDDDDDDDDDDDDDDDDDDT
TTTTTTTTTTTTTTTTTTTTTTTTTTTTTTTTTTTTTTTTTTTTTTTTTTTTTTTTTTTTTTTTTTTTTTTTTTTTTTTTTTTTTTTTTTTTTTTTTTTTTTTTTTTTTTTTTTTTTTTTTTTTTTTT
